######T##X###
#           #
######      #
#    #     X#
#    #      #
#    T#######
#    #
########
   X
   
