 ######X###############
######T##X######################
#           #
######      #
#    #     X#
#    #      #
#    ########
#    #
######