 #
######T#######
#           #
######      #
#    #     X#
#    #      #
#X   ########
#    #
######