######################
       #   #
       #   #
       #  ###########
       #  
       # 
       #
######################
#
#
#