######################
#          #
#          #
########   ###########
       #  
       # 
       #
######################
#
#
#