#############    ####
#           ######
######      #    #####
#    ########    #   #
#    #      #    #####
#    #############
#    #        #
########      #
   #          #
   ############
   
